NO ./file1
SO ./file2
WE ./file3
EA ./file4

F 220,100,0
C 225,30,255

        1111111111111111111111111
        1000000000110000000000001
        1011000001110000000000001
        1001000000000000000000001
111111111011000001110000000000001
100000000011000001110111111111111
11110111111111011100000010001
11110111111111001101010010001
11000000110101011100000010001
10000000000000001100000010001
10000000000000001101010010001
11000001100101011111011110S0111
11110111 1110101 101111010001
11111111 1111111 111111111111
