NO ./xpm/wall_cyberpunk2.XPM
SO ./xpm/wall_cyberpunk1.XPM
WE ./xpm/jepa.XPM
EA ./xpm/wall_cyberpunk2.XPM

F 50,10,15
C 66,22,200

        1111111111111111111111111
        1000000000110000000000001
        1011000001000000000000001
        1001000000000000000000001
111111111011000001110000000000001
100000000011000001110111111111111
11110111111111011100000010001 
11110111111111001101010010001
11000000110101011100000010001
10000000000000001100000010001
10000000000000000000010010111
110000011101010111100000000111
11110111 1110101 1011110100W1
11111111 1111111 111111111111
